+---+---+---+---+---+---+---+---+---+---+---+---+---+---+---+---+---+---+---+---+---+---+---+---+---+
    |           |       |           |                           |       |       |       |       |   |
    |           |       |           |                           |       |       |       |       |   |
    |           |       |           |                           |       |       |       |       |   |
+   +   +---+   +   +   +   +---+   +   +---+---+---+---+---+   +   +   +   +   +   +   +   +   +   +
|       |       |   |   |       |       |       |   |       |   |   |   |   |   |   |       |   |   |
|       |       |   |   |       |       |       |   |       |   |   |   |   |   |   |       |   |   |
|       |       |   |   |       |       |       |   |       |   |   |   |   |   |   |       |   |   |
+---+---+   +---+   +   +---+---+---+---+   +   +   +   +   +   +---+   +   +   +   +---+---+   +   +
|           |       |       |       |       |   |       |   |       |   |   |       |       |       |
|           |       |       |       |       |   |       |   |       |   |   |       |       |       |
|           |       |       |       |       |   |       |   |       |   |   |       |       |       |
+   +---+---+---+   +---+   +   +   +   +   +   +   +---+   +---+   +   +   +---+---+   +   +---+---+
|       |               |       |   |   |   |   |   |                       |           |           |
|       |               |       |   |   |   |   |   |                       |           |           |
|       |               |       |   |   |   |   |   |                       |           |           |
+---+   +   +---+---+---+---+---+   +   +   +   +---+   +   +---+   +---+---+   +---+---+---+---+   +
|           |   |                   |   |   |       |   |       |   |       |   |           |       |
|           |   |                   |   |   |       |   |       |   |       |   |           |       |
|           |   |                   |   |   |       |   |       |   |       |   |           |       |
+   +---+   +   +   +---+   +---+---+---+   +---+   +   +---+   +   +---+   +   +   +---+---+   +---+
|   |       |           |               |   |   |           |   |   |       |           |       |   |
|   |       |           |               |   |   |           |   |   |       |           |       |   |
|   |       |           |               |   |   |           |   |   |       |           |       |   |
+   +   +---+---+   +---+---+---+---+   +   +   +---+---+---+   +   +   +---+---+---+   +   +---+   +
|   |   |   |       |           |   |       |           |       |       |       |       |   |       |
|   |   |   |       |           |   |       |           |       |       |       |       |   |       |
|   |   |   |       |           |   |       |           |       |       |       |       |   |       |
+   +   +   +   +---+   +---+   +   +---+---+   +---+---+   +---+---+---+---+   +   +---+   +   +   +
|   |       |           |   |       |       |       |       |               |   |       |       |   |
|   |       |           |   |       |       |       |       |               |   |       |       |   |
|   |       |           |   |       |       |       |       |               |   |       |       |   |
+   +---+---+---+---+---+   +   +---+   +---+---+   +   +---+   +---+---+   +   +---+   +   +---+---+
|           |           |   |   |                       |   |       |   |   |       |   |           |
|           |           |   |   |                       |   |       |   |   |       |   |           |
|           |           |   |   |                       |   |       |   |   |       |   |           |
+   +---+---+   +---+   +   +   +   +---+---+---+   +---+   +---+   +   +   +---+   +   +---+---+   +
|               |           |   |   |       |       |       |   |       |       |   |       |       |
|               |           |   |   |       |       |       |   |       |       |   |       |       |
|               |           |   |   |       |       |       |   |       |       |   |       |       |
+---+---+---+---+   +   +---+---+   +---+   +   +---+   +   +   +---+---+---+   +   +---+   +   +---+
|           |       |   |   |       |       |   |       |       |       |       |       |   |       |
|           |       |   |   |       |       |   |       |       |       |       |       |   |       |
|           |       |   |   |       |       |   |       |       |       |       |       |   |       |
+   +---+---+   +---+   +   +   +---+   +---+   +   +---+---+---+---+   +   +---+---+   +   +---+   +
|               |       |   |       |       |   |       |       |       |   |       |   |   |       |
|               |       |   |       |       |   |       |       |       |   |       |   |   |       |
|               |       |   |       |       |   |       |       |       |   |       |   |   |       |
+---+---+---+---+   +   +   +---+   +   +   +   +---+   +   +   +   +   +   +   +   +   +   +   +---+
|   |       |       |   |           |   |       |           |       |   |       |   |   |   |       |
|   |       |       |   |           |   |       |           |       |   |       |   |   |   |       |
|   |       |       |   |           |   |       |           |       |   |       |   |   |   |       |
+   +   +   +   +---+---+---+---+---+   +---+---+   +---+---+   +---+---+---+---+   +   +   +---+   +
|   |   |       |           |       |   |       |   |   |               |           |   |   |       |
|   |   |       |           |       |   |       |   |   |               |           |   |   |       |
|   |   |       |           |       |   |       |   |   |               |           |   |   |       |
+   +   +---+---+   +---+   +   +   +---+   +   +   +   +   +   +---+   +   +---+---+   +   +   +---+
|   |   |   |           |       |           |       |       |       |       |       |   |   |   |   |
|   |   |   |           |       |           |       |       |       |       |       |   |   |   |   |
|   |   |   |           |       |           |       |       |       |       |       |   |   |   |   |
+   +   +   +   +---+---+---+   +   +---+---+   +---+---+---+---+---+---+---+   +---+   +   +   +   +
|   |           |           |   |           |   |               |       |   |               |   |   |
|   |           |           |   |           |   |               |       |   |               |   |   |
|   |           |           |   |           |   |               |       |   |               |   |   |
+   +---+   +---+   +---+   +---+---+---+   +   +   +---+---+   +   +   +   +   +---+   +---+   +   +
|           |       |   |           |       |   |   |       |       |   |           |       |       |
|           |       |   |           |       |   |   |       |       |   |           |       |       |
|           |       |   |           |       |   |   |       |       |   |           |       |       |
+---+---+---+   +   +   +---+---+   +   +---+   +   +---+   +---+---+   +---+---+---+---+   +---+---+
|               |   |   |       |       |       |           |               |           |           |
|               |   |   |       |       |       |           |               |           |           |
|               |   |   |       |       |       |           |               |           |           |
+   +---+---+---+   +   +   +---+---+---+   +---+---+---+   +   +---+---+---+   +   +---+---+   +   +
|   |           |   |   |   |           |       |   |       |                   |               |   |
|   |           |   |   |   |           |       |   |       |                   |               |   |
|   |           |   |   |   |           |       |   |       |                   |               |   |
+   +   +---+   +---+   +   +   +---+   +---+   +   +   +   +---+---+---+---+---+   +---+---+---+   +
|   |   |       |           |   |   |       |           |   |                       |           |   |
|   |   |       |           |   |   |       |           |   |                       |           |   |
|   |   |       |           |   |   |       |           |   |                       |           |   |
+   +---+   +---+   +   +---+   +   +---+---+---+---+---+---+   +---+---+---+   +---+   +---+---+   +
|                   |       |   |       |                   |       |       |       |   |       |   |
|                   |       |   |       |                   |       |       |       |   |       |   |
|                   |       |   |       |                   |       |       |       |   |       |   |
+---+---+   +---+---+---+   +   +---+   +   +---+---+---+   +---+---+   +   +---+   +   +   +   +   +
|           |           |   |               |   |       |               |       |   |   |   |       |
|           |           |   |               |   |       |               |       |   |   |   |       |
|           |           |   |               |   |       |               |       |   |   |   |       |
+   +---+---+---+---+   +   +---+---+---+---+   +   +   +---+---+---+---+---+   +   +   +   +---+---+
|   |               |   |       |               |   |   |           |       |       |   |   |       |
|   |               |   |       |               |   |   |           |       |       |   |   |       |
|   |               |   |       |               |   |   |           |       |       |   |   |       |
+   +   +---+---+   +   +---+   +   +---+---+   +   +   +   +---+   +   +   +---+---+   +   +   +   +
|   |   |   |       |   |   |       |       |       |       |       |   |       |   |           |   |
|   |   |   |       |   |   |       |       |       |       |       |   |       |   |           |   |
|   |   |   |       |   |   |       |       |       |       |       |   |       |   |           |   |
+   +   +   +   +---+   +   +---+---+   +   +---+---+---+---+   +---+   +---+   +   +---+---+---+   +
|       |       |                       |                               |       |
|       |       |                       |                               |       |
|       |       |                       |                               |       |
+---+---+---+---+---+---+---+---+---+---+---+---+---+---+---+---+---+---+---+---+---+---+---+---+---+
